#java/io/File.<init>(Ljava/io/File;Ljava/lang/String;)V	1
java/io/File.<init>(Ljava/lang/String;)V	0
java/io/File.<init>(Ljava/lang/String;Ljava/lang/String;)V	0
java/io/FileInputStream.<init>(Ljava/lang/String;)V	0
java/io/FileOutputStream.<init>(Ljava/lang/String;)V	0
java/io/FileOutputStream.<init>(Ljava/lang/String;Z)V	0
java/io/FilePermission.<init>(Ljava/lang/String;Ljava/lang/String;)V	0
java/io/FileReader.<init>(Ljava/lang/String;)V	0
java/io/FileWriter.<init>(Ljava/lang/String;)V	0
java/io/FileWriter.<init>(Ljava/lang/String;Z)V	0
java/io/RandomAccessFile.<init>(Ljava/lang/String;Ljava/lang/String;)V	0
java/net/URI.<init>(Ljava/lang/String;)V	URI
java/net/URI.<init>(Ljava/lang/String;Ljava/lang/String;Ljava/lang/String;)V	URI
java/net/URI.<init>(Ljava/lang/String;Ljava/lang/String;Ljava/lang/String;ILjava/lang/String;Ljava/lang/String;Ljava/lang/String;)V	URI
java/net/URI.<init>(Ljava/lang/String;Ljava/lang/String;Ljava/lang/String;Ljava/lang/String;)V	URI
java/net/URI.<init>(Ljava/lang/String;Ljava/lang/String;Ljava/lang/String;Ljava/lang/String;Ljava/lang/String;)V	URI
java/net/URL.<init>(Ljava/lang/String;)V	URL
java/net/URL.<init>(Ljava/lang/String;Ljava/lang/String;ILjava/lang/String;)V	URL
java/net/URL.<init>(Ljava/lang/String;Ljava/lang/String;ILjava/lang/String;Ljava/net/URLStreamHandler;)V	URL
java/net/URL.<init>(Ljava/lang/String;Ljava/lang/String;Ljava/lang/String;)V	URL
java/nio/file/FileSystem.getPath(Ljava/lang/String;[Ljava/lang/String;)Ljava/nio/file/Path;	FS
java/nio/file/FileSystems.getDefault()Ljava/nio/file/FileSystem;	FS
java/nio/file/Path.relativize(Ljava/nio/file/Path;)Ljava/nio/file/Path;	PATH
java/nio/file/Path.resolve(Ljava/lang/String;)Ljava/nio/file/Path;	0
java/nio/file/Path.resolveSibling(Ljava/lang/String;)Ljava/nio/file/Path;	PATH
java/nio/file/Path.resolveSibling(Ljava/nio/file/Path;)Ljava/nio/file/Path;	PATH
java/util/jar/JarFile.<init>(Ljava/lang/String;)V	0
java/util/jar/JarFile.<init>(Ljava/lang/String;Z)V	0
java/util/zip/ZipFile.<init>(Ljava/lang/String;)V	0
java/util/zip/ZipFile.<init>(Ljava/lang/String;Ljava/nio/charset/Charset;)V	0
javax/swing/filechooser/FileSystemView$FileSystemRoot.<init>(Ljava/lang/String;)V	0
